While watching TV in the living room, you turn your head towards the window and notice something strange outside. You can't make out what it is because of all the snow outside. So you go to investigate.

Alien Snow
An Interactive Fiction by EJ Talavera
Release 1 / Serial number 141028 / Inform 7 build 6L38 (I6/v6.33 lib 6/12N) SD

Living Room
A place where you and your family like to hang out. There's a TV on the east side of the room. A couch surrounding the TV and a pattern carpet on the floor. North is the front yard, east is the bedroom, and south is the kitchen.

>s
Kitchen
A place where you mom creates the best dishes you have ever tasted, but since you can't cook you don't really come in here that often. North is the living room and east is the Lab.

You can see Knives here.

>w
You can't go that way.

>e
Lab
A place where you and your friend Erwin like to do your science experiments. You have all the best tools such as computers, hazmat suits and many other things.

You can see Steel door and Erwin here.

>n
(first opening Steel door)
The door is sealed shut and seems like opens only when the correct combination is spun in the spin dial at once. You must spin the dial to the correct 5 digit code.

>dial 91998
That's not a verb I recognise.

>spin dial to 91998
The door unlocks and opens with a hiss

>open door
You open Steel door.

>n
Testing Room
You can see Steel door here.

* * *

>e
Lab
A place where you and your friend Erwin like to do your science experiments. You have all the best tools such as computers, hazmat suits and many other things.

You can see Steel door and Erwin here.

>s
Bathroom

>w
You can't go that way.

>n
Lab
You can see Steel door and Erwin here.

>w
Kitchen

>n
Living Room
A place where you and your family like to hang out. There's a TV on the east side of the room. A couch surrounding the TV and a pattern carpet on the floor.

>e
Bedroom
You can see Wooden Handle here.

>take handel
You can't see any such thing.

>take handel
You can't see any such thing.

>take handle
Taken.

>w
Living Room
A place where you and your family like to hang out. There's a TV on the east side of the room. A couch surrounding the TV and a pattern carpet on the floor.

>s
Kitchen

>e
Lab
You can see Steel door and Erwin here.

>e
Backyard

>s
Bunker
You can see Metal head here.

>take metal head
Taken.

>combine metal head with wooden handel
I only understood you as far as wanting to combine Metal head with Wooden Handle.

>combine head with handle
You fuse together Metal head and Wooden Handle.

You now have a Sledgehammer.

>n
Backyard

>w
Lab
You can see Steel door and Erwin here.

>s
Bathroom

>n
Lab
You can see Steel door and Erwin here.

* * *

>n
Living Room
A place where you and your family like to hang out. There's a TV on the east side of the room. A couch surrounding the TV and a pattern carpet on the floor.

>n
Front Yard
The front yard of your house where you play with your dog and do all yout family activities. There is snow covering the yard and everything in sight. There is a ice pond in the middle of the yard.

You can see Bucket of Snow and Ice Angel here.

>break Ice pond with sledgehammer
I only understood you as far as wanting to break Ice pond.

>unlock Ice pond with sledgehammer
You unlock Ice pond.

>open ice pond
You open Ice pond, revealing Ice heart.

>take heart
Taken.

>give ice heart to angel
Ice Angel doesn't seem interested.

* * *

>e
Lab
A place where you and your friend Erwin like to do your science experiments. You have all the best tools such as computers, hazmat suits and many other things.

You can see Steel door and Erwin here.

>e
Backyard
A place where you and your family like to host parties and other stuff. There are only benches in the backyard that way it leaves more space for you to play around.

>s
Bunker
A place where you and your family go if there is ever a tornado or anytime of storm that could destroy the house. There are beds and charis to keep everyone comfortable.

You can see Metal head here.

>n
Backyard
A place where you and your family like to host parties and other stuff. There are only benches in the backyard that way it leaves more space for you to play around.

>w
Lab
A place where you and your friend Erwin like to do your science experiments. You have all the best tools such as computers, hazmat suits and many other things.

You can see Steel door and Erwin here.

>w
Kitchen
A place where you mom creates the best dishes you have ever tasted, but since you can't cook you don't really come in here that often.

You can see Knives here.

>n
Living Room
A place where you and your family like to hang out. There's a TV on the east side of the room. A couch surrounding the TV and a pattern carpet on the floor.

>e
Bedroom
 A place you go to sleep. A kingsize bed which basically takes up the whole room and a small TV that helps you go to sleep.

You can see Boots and Wooden Handle here.

* * *

>w
You can't go that way.

>n
Living Room
A place where you and your family like to hang out. There's a TV on the east side of the room. A couch surrounding the TV and a pattern carpet on the floor.

* * *

>e
Bedroom
You can see Wooden Handle here.

>take handle
Taken.

* * *

>s
Bunker
You can see Metal head here.

>take head
Taken.

>combine head with handle
You fuse together Metal head and Wooden Handle.

You now have a Sledgehammer.

>s
You can't go that way.

>n
Backyard

>s
Bunker

>n
Backyard

* * *

>w
Lab
You can see Steel door and Erwin here.

>w
Kitchen

>w
You can't go that way.

* * *

>n
Front Yard
The front yard of your house where you play with your dog and do all yout family activities. There is snow covering the yard and everything in sight. There is a ice pond in the middle of the yard.

You can see Bucket of Snow and Ice Angel here.

>unlock Ice pond with sledgehammer
You unlock Ice pond.

>open pond
You open Ice pond, revealing Ice heart.

>take heart
Taken.

>give heart to angel
Thank you kind human for returning the Ice heart. We will leave this planet in peace.

* * *

>s
Kitchen
A place where you mom creates the best dishes you have ever tasted, but since you can't cook you don't really come in here that often. North is the living room and east is the Lab.

You can see Knives here.

>n
Living Room
A place where you and your family like to hang out. There's a TV on the east side of the room. A couch surrounding the TV and a pattern carpet on the floor. North is the front yard, east is the bedroom, and south is the kitchen.

>e
Bedroom
You can see Wooden Handle here.

* * *

>take handle
Taken.

>w
Living Room

>s
Kitchen

* * *

>take handle
Taken.

>s
You can't go that way.

>w
Living Room

* * *

>s
Kitchen

>w
You can't go that way.

>e
Lab
You can see Steel door and Erwin here.

* * *

>combine head with handle
You fuse together Metal head and Wooden Handle.

You now have a Sledgehammer.

>x sledgehammer
A sledgehammer that is used to break things.

* * *

>n
Living Room
A place where you and your family like to hang out. There's a TV on the east side of the room. A couch surrounding the TV and a pattern carpet on the floor. North is the front yard, east is the bedroom, and south is the kitchen.

>w
You can't go that way.

>e
Bedroom
 A place you go to sleep. A kingsize bed which basically takes up the whole room and a small TV that helps you go to sleep. West is the living room.

You can see Boots and Wooden Handle here.

>w
Living Room
A place where you and your family like to hang out. There's a TV on the east side of the room. A couch surrounding the TV and a pattern carpet on the floor. North is the front yard, east is the bedroom, and south is the kitchen.

>n
Front Yard
The front yard of your house where you play with your dog and do all yout family activities. There is snow covering the yard and everything in sight. There is a ice pond in the middle of the yard. South is the living room

You can see Bucket of Snow and Ice Angel here.

>s
Living Room
A place where you and your family like to hang out. There's a TV on the east side of the room. A couch surrounding the TV and a pattern carpet on the floor. North is the front yard, east is the bedroom, and south is the kitchen.

>s
Kitchen
A place where you mom creates the best dishes you have ever tasted, but since you can't cook you don't really come in here that often. North is the living room and east is the Lab.

You can see Knives here.

>e
Lab
A place where you and your friend Erwin like to do your science experiments. You have all the best tools such as computers, hazmat suits and many other things. East is the Backyard and west is the kitchen.

You can see Steel door and Erwin here.

>e
Backyard
A place where you and your family like to host parties and other stuff. There are only benches in the backyard that way it leaves more space for you to play around. South is the bunker and west is the lab

* * *

>e
Bedroom
 A place you go to sleep. A kingsize bed which basically takes up the whole room and a small TV that helps you go to sleep. West is the living room.

You can see Boots and Wooden Handle here.

>take handle
Taken.

* * *

>w
Living Room
A place where you and your family like to hang out. There's a TV on the east side of the room. A couch surrounding the TV and a pattern carpet on the floor.

>s
Kitchen
A place where you mom creates the best dishes you have ever tasted, but since you can't cook you don't really come in here that often.

>s
You can't go that way.

>e
Lab
You can see Steel door and Erwin here.

* * *

>e
Backyard

>e
You can't go that way.

>n
You can't go that way.

>s
Bunker
You can see Metal head here.

* * *

>w
Lab
You can see Steel door and Erwin here.

>w
Kitchen
A place where you mom creates the best dishes you have ever tasted, but since you can't cook you don't really come in here that often.

>w
You can't go that way.

* * *

>n
Front Yard
The front yard of your house where you play with your dog and do all yout family activities. There is snow covering the yard and everything in sight. There is a ice pond in the middle of the yard.

You can see Bucket of Snow and Ice Angel here.

>unlock pond with sledgehammer
You unlock Ice pond.

>open pond
You open Ice pond, revealing Ice heart.

* * *

>take heart
Taken.

>give heart to angel
Thank you kind human for returning the Ice heart. We will leave this planet in peace.

    *** You win, you have succesfully retrieved the Ice heart to the angels before anything bad could happen. ***

Would you like to RESTART, RESTORE a saved game, QUIT or UNDO the last command?

* * *

>s
Kitchen
A place where you mom creates the best dishes you have ever tasted, but since you can't cook you don't really come in here that often. North is the living room and east is the Lab.

You can see Knives here.

>s
You can't go that way.

>e
Lab

* * *

>s
Kitchen
A place where you mom creates the best dishes you have ever tasted, but since you can't cook you don't really come in here that often. North is the living room and east is the Lab.

You can see Knives here.

>e
Lab
A place where you and your friend Erwin like to do your science experiments. You have all the best tools such as computers, hazmat suits and many other things. East is the Backyard and west is the kitchen.

You can see Erwin here.

>w
Kitchen
A place where you mom creates the best dishes you have ever tasted, but since you can't cook you don't really come in here that often. North is the living room and east is the Lab.

You can see Knives here.

>e
Lab
A place where you and your friend Erwin like to do your science experiments. You have all the best tools such as computers, hazmat suits and many other things. East is the Backyard and west is the kitchen.

You can see Erwin here.

>e
backyard
A place where you and your family like to host parties and other stuff. There are only benches in the backyard that way it leaves more space for you to play around. South is the bunker and west is the lab

You can see Steel door here.

>open door
The door is sealed shut and seems like opens only when the correct combination is spun in the spin dial at once. You must spin the dial to the correct 5 digit code.

>s
(first opening Steel door)
The door is sealed shut and seems like opens only when the correct combination is spun in the spin dial at once. You must spin the dial to the correct 5 digit code.

>s
(first opening Steel door)
The door is sealed shut and seems like opens only when the correct combination is spun in the spin dial at once. You must spin the dial to the correct 5 digit code.

>n
You can't go that way.

>w
Lab
A place where you and your friend Erwin like to do your science experiments. You have all the best tools such as computers, hazmat suits and many other things. East is the Backyard and west is the kitchen.

You can see Erwin here.

>ask erwin about dial code
The code is 2369, I wrote it in the palm of my hand incase I forgot.

>e
backyard
A place where you and your family like to host parties and other stuff. There are only benches in the backyard that way it leaves more space for you to play around. South is the bunker and west is the lab

You can see Steel door here.

>dial 2369
That's not a verb I recognise.

>spin dial to 2369
The door unlocks and opens with a hiss

>open door
You open Steel door.

* * *

>e
Lab
A place where you and your friend Erwin like to do your science experiments. You have all the best tools such as computers, hazmat suits and many other things. East is the Backyard and west is the kitchen.

You can see Erwin here.

>n
Testing Room
A place where you and alfred run all your test and simulations.

* * *

While watching TV in the living room, you turn your head towards the window and notice something strange outside. You can't make out what it is because of all the snow outside. So you go to investigate.

Alien Snow
An Interactive Fiction by EJ Talavera
Release 1 / Serial number 141028 / Inform 7 build 6L38 (I6/v6.33 lib 6/12N) SD

Living Room
A place where you and your family like to hang out. There's a TV on the east side of the room. A couch surrounding the TV and a pattern carpet on the floor. North is the front yard, east is the bedroom, and south is the kitchen.

>n
Front Yard
The front yard of your house where you play with your dog and do all your family activities. There is snow covering the yard and everything in sight. There is an ice pond in the middle of the yard. South is the living room

You can see Bucket of Snow and Ice Angel here.

>s
Living Room
A place where you and your family like to hang out. There's a TV on the east side of the room. A couch surrounding the TV and a pattern carpet on the floor. North is the front yard, east is the bedroom, and south is the kitchen.

>e
Bedroom
 A place you go to sleep. A king-size bed that basically takes up the whole room and a small TV that helps you go to sleep. West is the living room.

You can see Boots and Wooden Handle here.

>w
Living Room
A place where you and your family like to hang out. There's a TV on the east side of the room. A couch surrounding the TV and a pattern carpet on the floor. North is the front yard, east is the bedroom, and south is the kitchen.

>s
Kitchen
A place where your mom creates the best dishes you have ever tasted, but since you can't cook you don't really come in here that often. North is the living room and east is the Lab.

You can see Knives here.

>e
Lab
A place where you and your friend Erwin like to do your science experiments. You have all the best tools such as computers, HAZMAT suits and many other things. East is the Backyard, west is the kitchen, and north is the bathroom.

You can see Erwin here.

>e
backyard
A place where you and your family like to host parties and other stuff. There are only benches in the backyard that way it leaves more space for you to play around. South is the bunker and west is the lab

You can see Steel door here.

* * *

>e
Lab
A place where you and your friend Erwin like to do your science experiments. You have all the best tools such as computers, HAZMAT suits and many other things. East is the Backyard, west is the kitchen, and north is the bathroom.

You can see Erwin here.

>s
You can't go that way.

>w
Kitchen
A place where your mom creates the best dishes you have ever tasted, but since you can't cook you don't really come in here that often. North is the living room and east is the Lab.

You can see Knives here.

>e
Lab
A place where you and your friend Erwin like to do your science experiments. You have all the best tools such as computers, HAZMAT suits and many other things. East is the Backyard, west is the kitchen, and north is the bathroom.

You can see Erwin here.

* * *

>n
Front Yard
The front yard of your house where you play with your dog and do all your family activities. There is snow covering the yard and everything in sight. There is an ice pond in the middle of the yard. South is the living room

You can see Bucket of Snow and Ice Angel here.

>x pond
A ice pond that has been frozen over. But it seems like you can see something inside the pond but you can't make out what it is. Maybe if you break open the pond, you might be able to get it.

Maybe a sledgehammer would do the trick.

>x Ice angel
A alien being from another planet that seems to be made out of ice. Maybe you should ask about it coming to earth.

>ask Ice angel about coming to earth
We have come here becuase we have lost an object very valuable to us and we will not leave until we've got it.

>s
Living Room
A place where you and your family like to hang out. There's a TV on the east side of the room. A couch surrounding the TV and a pattern carpet on the floor. North is the front yard, east is the bedroom, and south is the kitchen.

>e
Bedroom
 A place you go to sleep. A kingsize bed which basically takes up the whole room and a small TV that helps you go to sleep. West is the living room.

You can see Boots and Wooden Handle here.

* * *

>take handle
Taken.

>n
You can't go that way.

>s
You can't go that way.

>w
Living Room
A place where you and your family like to hang out. There's a TV on the east side of the room. A couch surrounding the TV and a pattern carpet on the floor. North is the front yard, east is the bedroom, and south is the kitchen.

* * *

>s
Kitchen
A place where your mom creates the best dishes you have ever tasted, but since you can't cook you don't really come in here that often. North is the living room and east is the Lab.

You can see Knives here.

>e
Lab
A place where you and your friend Erwin like to do your science experiments. You have all the best tools such as computers, hazmat suits and many other things. East is the Backyard and west is the kitchen.

You can see Erwin here.

>ask Erwin about snow
Sorry man I dont know what that it is. Wow thats a first.

* * *

>n
Front Yard
The front yard of your house where you play with your dog and do all your family activities. There is snow covering the yard and everything in sight. There is an ice pond in the middle of the yard. South is the living room

You can see Bucket of Snow and Ice Angel here.

>x Ice Angel
A alien being from another planet that seems to be made out of ice. Maybe you should ask about it coming to earth.

>ask Ice Angel about coming to earth
We have come here becuase we have lost an object very valuable to us and we will not leave until we've got it.

>ask about object
You can't see any such thing.

>ask Ice Angel about object
There is no reply.

* * *

>x Ice Angel
A alien being from another planet that seems to be made out of ice. Maybe you should ask about it coming to earth.

>Ask Ice Angel about coming to earth
We have come here becuase we have lost an object very valuable to us and we will not leave until we've got it.

* * *

While watching TV in the living room, you turn your head towards the window and notice something strange outside. You can't make out what it is because of all the snow outside. So you go to investigate.

Alien Snow
An Interactive Fiction by EJ Talavera
Release 1 / Serial number 141028 / Inform 7 build 6L38 (I6/v6.33 lib 6/12N) SD

Living Room
A place where you and your family like to hang out. There's a TV on the east side of the room. A couch surrounding the TV and a pattern carpet on the floor. North is the front yard, east is the bedroom, and south is the kitchen.

>w
You can't go that way.

>e
Bedroom
You can see Wooden Handle here.

* * *

>s
Kitchen

>s
You can't go that way.

>w
You can't go that way.

>w
You can't go that way.

* * *

>take head
Taken.

>combine handle with head
You fuse together Wooden Handle and Metal head.

You now have a Sledgehammer.

>s
You can't go that way.

* * *

>w
You can't go that way.

>n
Living Room

>n
Front Yard
The front yard of your house where you play with your dog and do all yout family activities. There is snow covering the yard and everything in sight. There is a ice pond in the middle of the yard.

You can see Bucket of Snow and Ice Angel here.

>unlock Ice pond with Sledgehammer
You unlock Ice pond.